 wwwwwwwwwww
ww_________ww
w__r_____r__w
w_rw_wgw_wr_w
w____wRw____wwwww
w__wwwgwww__w___w
w__gRgpgRg______w
w__wwwgwww__w___w
w____wRw____wwwww
w_rw_wgw_wr_w
w__r_____r__w
ww_________ww
 wwwwwwwwwww