     wwwww
    ww___w
    w____w
  www____wwwwww
  wgwgw_wwg___w
www_www__ww___w
w___w__r__ww_ww
w_____rpr_____w
w___w__r__w___w
wwwwww___www_ww
 w__gww_wwww_w
 w___________w
 ww__wwwwwwwww
  wwww