     w     w
    wwwwwwwww
     w_____w
   www_____www
 w w_w_____w_w w
wwwwww_wgw_wwwwww
 w____rg_gr____w
 w___w_wrw_w___w
 w___g_rpr_g___w
 w___w_wrw_w___w
 w____rg_gr____w
wwwwww_wgw_wwwwww
 w w_w_____w_w w
   www_____www
     w_____w
    wwwwwwwww
     w     w