wwwwww
w____www
w_ww___w
w______w
w_ww_r_wwww
wgw_r_r_wgw
wgw__r__wgw
wgw_r_r_wgw
wgw__r__wgw
wgw_r_r_wgw
wwww_r_ww_w
   w_p____w
   w___ww_w
   www____w
     wwwwww