       wwwwwww
       w_____w
       w_rrr_w
       w_____w
     wwww_w_wwww
wwwwww____g____wwwwww
w___w____ggg____w___w
w___r__wwgggww__r___w
w___w____ggg____w___w
wwwwww____g____wwwwww
     wwww_w_wwww
       w_____w
       w_rrr_w
       w_____w
    wwwwwwpwwwwww
    w___w___w___w
    w___r_r_r___w
    wwwww___wwwww
        wwwww