     wwwww
    ww___ww
  www_r_r_www
 ww___w_w___ww
ww___________ww
w_rw__ggg_wr__w
w_____gpg_____w
w__rw_ggg__wr_w
ww___________ww
 ww___w_w___ww
  www_r_r_www
    ww___ww
     wwwww