          wwwww
    wwwwwwwgggw
    w________gw
    w________gw
  www__r__w__ww
  w___rwr___ww
  w____w____w
  w_rwrwrwr_w
  w____w____w
 ww___rwr___w
ww__w__r__www
wg________w
wg_____p__w
wgggwwwwwww
wwwww