     wwwwww
   wwww___w
   w__w___w
 www__r___w
 wgg_r_r__w
 wgg_wwwrww
 wgg__r___w
www_ww__r_w
w___ww_w_pw
w_www__wwww
w_____ww
wwwwwww