 wwwwwwwwwww
ww______w__w
w__wg___w__w
w______gw__w
wwrrwwpwwrrww
 w__wg______w
 w__w___gw__w
 w__w______ww
 wwwwwwwwwww