wwwwwwww
wgw____w
wgw_ww_wwww
wgw_r___r_w
wgw_w_w_w_w
wgw_w_w_w_w
w___w_w___w
w_r_r_w_r_w
w___wp__www
wwwwwwwww