      www
      wgw
  wwwwwgwwwww
 ww_________ww
ww__w_w_w_w__ww
w__ww_____ww__w
w_ww__w_w__ww_w
w_____rpr_____w
wwww__www__wwww
   wwww wwww