     wwwww
     w___w
     w___w
wwww w___w
w__wwwwrwwwww
w___________w
w_gww_w_wwg_w
w___________w
wwwwwrwwww__w
   w___w wwww
   w_p_w
   w___w
   wwwww