wwww     wwww
w_gwwwwwwwg_w
wg_________gw
ww_ww___ww_ww
 w_w_____w_w
 w___wrw___w
 w___rpr___w
 w___wrw___w
 www_____www
wwgww_w_wwgww
w___r_w_r___w
w__ww_w_ww__w
ww_wg___gw_ww
 w_r_____r_w
 w_ww_w_ww_w
 w_________w
 wwwwwwwwwww